###################
#########...i.#####
##.7..8.#####h.####
##6####.#a..##.g..#
##.#.#.9..#.#..##.#
##.5.######b###.f.#
####4#2.1.#.#.e.###
####.#.##0#k.d#####
####.3..#s#.#######
###################